Kingdom of Germany: King og Germany(Heinrich II Hochenstaufen)
Kingdom of Franken: Franconian Rake
Duchy of ostfranken: princebishop of Wurzburg arms
Wurzburg: Rennfähnlein
Bamberg: princebishops of Bramberg arms
Henneberg:counts of Henneberg(von Henneberg) arms
Wertheim: counts of Wertheim(von Wertheim) arms
Hohenlohe:counts of Hohenlohe(von Hohenlohe) arms
Duchy of Westfranken: Franken arms quarterd with the Reichadler
Hanau:lords and count of Hanau(von Hanau)arms
Katzenelbogen:counts of Katzenelbogen(von Katezenelbogen) arms
Nassau: counts of Nassau arms(von Nassau)
Sayn: counts of Sayn(von Sayn) arms
Palatine of the Rhein: count palatine of the Rheine(Wittelbach) arms
Pfalz: count palatine of the Rheine(Hohenstatufen) arms
Leiningen: counts of Leiningen(von Leiningen) arms
Zweibrücken:counts of Zweibrücken(von Zweibrücken) arms
Sponheim: counts of Sponheim(von Sponheim) arms
Archbishoperic of Mainz: Prince Archbishoperic of Mainz arms
Mainz: Prince Archbishoperic of Mainz arms
Duchy of Hessen: landgraves of Hessen(von Hessen)
Gudensberg: landgraves of Hessen(von Hessen ancient)
Gleiberg: counts of Solms(von Solms) arms
Ziegenhain: counts of Ziegenhain(von Ziegenhain) arms
Duchy of Thüringen:landgraves of Thüringen(Ludowinger) arms
Thüringen: landgraves of Thüringen(Ludowinger ancient) arms
Weimar:counts of Weimar(von Weimar-Orlamünde) arms
Schwarzburg:counts of Schwarzburg(von Schwarzburg/Schwarzenburgstrasse) arms
Burgraviate of Nürnberg:Burgraves of Nürnberg(Hohenzollern)
Nürnberg::Burgraves of Nürnberg(Raabs)
Truhendingen:counts of Truhendingen(von Truhendingen) arms
Sonneberg: counts of Sonneberg(von Sonnenberg) arms