Kingdom of Saxony flags list
Kingdom of Saxony: Henry the Lion arms
Duchy of Meissen: margraves of Meissen and Lausitz(Dietrich I, Wettin) arms
Meissen: count og Wettin and margraves of Meissen(Otto der reiche, Wettin) arms
Landsberg: Margraves of Landsberg(Wettin) arms
Groitzsch: count of Groitzsch(von Groitzsch) arms
Voigtland(c_plauen): Voigte of Weida, Plauen and Gera(Reuss-Kranichfeld) arms
Duchy of Lausitz: margraves of Lower Lausitz(Wettin) arms
Oberlausitz(c_lausitz): vogtei of Upper Lausitz under Bohemia arms
Niederlausitz: margraves of Lausitz and vogtei of Lower Lausitz under Bohemia, arms
Duchy of Wittenberg:duke of Saxe-Wittenberg and count of Brehna arms(Rudolf I, Ascanien)
Wittenberg: dukes of Saxe-Wittenberg arms(Ascanien and Wettin) 
Anhalt: count and princes of Anhalt(Ascanien) arms
Brehna: counts of Brehna(von Brehna) arms
Mansfeld: counts of Mansfeld(von Mansfeld) arms
Duchy of Lauenburg: dukes of Saxe-Lauenburg arms(Ascanien)
Ratzeburg: Lauenburg horsehead arms(another attribute to the royal Danish arms)
Schwerin: counts of Schwerin(the dragons and the tree was used as one of the countly arms by both Hagen and Hagen-Wittenburg since at least mid 13th century, but afaik its not tied to them dynasitcally. Dynastically von Hagen had a silver and red checkered arms while von Hagen-Wittenburg had a red field above gold) arms
Dannenberg: counts of Dannenberg(von Dannenberg) arms
Duchy of Holstein: Duchy of Holstein arms(as attributed in the Danish royal arms)
Rendsburg(c_holstein): counts of Holstein-Rendsburg(Heinrich II,Schauenburg) arms
Stormarn(c_hamburg)/Pinneberg: counts of Holstein-Pinneberg(Adolf VIII, Schauenburg) arms
Kiel:counts of Holstein-Kiel(Johann III, Schauenburg) arms
Dithmarschen: Dithmarschen knight arms(another royal Danish arms attribute)
Duchy of Braunschweig-Lüneburg: dukes of Braunschweig-Lüneburg(Welf) arms
Lüneburg: dukes and princes of Lüneburg(Welf) arms
Braunschweig: dukes and princes of Braunschweig(Welf) arms
Blankenburg: counts of Blankenburg(von Reggenstein) arms
Everstein: counts of Everstein(von Everstein) arms
Northeim(c_gottingen): lords of Grone(von Grone) arms
Duchy of Engern: duchy of Engern arms
Stade: counts of Stotel arms(von Stotel)
Bremen: princebishoperic of Bremen arms
Oldenburg: counts of Oldenburg(von Oldenburg) and Delmenhorst arms(also featured as an attribute in the royal Danish arms)
Hoya: counts of Hoya(von Hoya/von Stumpenhusen) arms
Schauenburg: counts of Schauenburg/Schaumburg and Holstein(von Schauenburg) arms
Lippe: lords and princes of Lippe(von Lippe) arms
Duchy of Westphalia: 1st duke of Westphalia, and archbishop of Köln, Philipp von Heinsberg arms
Arnsberg: counts of Arnsberg(von Arnsberg) arms
Mark: counts of Mark(de la Mark) arms
Ravensberg(c_osnabruck): counts of Ravensberg arms
Münster: princebishoperic of Münster arms
Tecklenburg: counts of Teckleburg-Lingen arms
Bentheim: counts of Bentheim(von Bentheim) arms